,Line_1,Line_2,Line_3,Line_4,Line_5,Line_6,Line_7,Line_8,Line_9,Line_10,Line_11,Line_12,Line_13,Line_14,Line_15,
1,Ns,,,,,,,s,,,,,,,Ns,
2,,,,,,,,,,,,,,,,
3,,,,,,,,,,,,,,,,
4,,,,,,,,,,,,,,,,
5,,,,,,,,,,,,,,,,
6,,,,,,,,,,,,,,,,
7,,,,,,,,,,,,,,,,
8,,,,,,,,,,,,,,,,
9,,,,,,,,,,,,,,,,
10,,,,,,,,,,,,,,,,
11,,,,,,,,,,,,,,,,
12,,,,,,,,,,,,,,,,
13,,,,,,,,,,,,,,,,
14,,,,,,,,,,,,,,,,
15,,,,,,,,,,,,,,,,
16,,,,,,,,,,,,,,,,
17,,,,,,,,,,,,,,,,
18,,,,,,,,,,,,,,,,
19,,,,,,,,,,,,,,,,
20,,,,,,,,,,,,,,,,
21,,,,,,,,,,,,,,,,
22,,,,,,,,,,,,,,,,
23,,,,,,,,,,,,,,,,
24,,,,,,,,,,,,,,,,
25,,,,,,,,,,,,,,,,
26,,,,,,,,,,,,,,,,
27,,,,,,,,,,,,,,,,
28,,Ps,,,Pr,,,,C,,,Ps,,Pr,,
29,,,,,,,,,,,,,,,,
30,,,,,,,,,C,,,,,,,
31,,,,,,,,,,,,,,,,
32,,,,,,,,C,,,,,,,,
33,,,,,,,,,,,,,,,,
34,,,,,,,,,,,,,,,,
35,,,,,,,,,,,,,,,,
36,,,,,,,,,,,,,,,,
37,,,,,,,,,,,,,,,,
38,,,,,,,,,,,,,,,,
39,,,,,,,,,,,,,,,,
40,,,,,,,,,,,,,,,,
41,,,,,,,,,,,,,,,,
42,,,,,,,,,,,,,,,,
43,,,,,,,,,,,,,,,,
44,,,,,,,,,,,,,,,,
45,,,,,,,,,,,,,,,,
46,,Ps,,Pr,,C,,,,Ps,,,,Pr,,
47,,,,,,,,,,,,,,,,
48,,,,,,C,,,,,,,,,,
49,,,,,,,,,,,,,,,,
50,,,,,,,C,,,,,,,,,
51,,,,,,,,,,,,,,,,
52,,,,,,,,,,,,,,,,
53,,,,,,,,,,,,,,,,
54,,,,,,,,,,,,,,,,
55,,,,,,,,,,,,,,,,
56,,Ps,,Pr,,,,C,,,Ps,,,Pr,,
57,,,,,,,,,,,,,,,,
58,,,,,,,,,,,,,,,,
59,,,,,,,,,,,,,,,,
60,,,,,,,,,,,,,,,,
61,,,,,,,,,,,,,,,,
62,,,,,,,,,,,,,,,,
63,,,,,,,,,,,,,,,,
64,,Ps,,Pr,,,C,,Ps,,,,,Pr,,
65,,,,,,,,,,,,,,,,
66,,,,,,,,,,,,,,,,
67,,Ps,,,Pr,,,,,Ps,,,,Pr,,
68,,,,,,,,,,,,,,,,
69,,,,,,,,,,,,,,,,
70,,Ps,,,,Pr,,,C,,Ps,,,Pr,,
71,,,,,,,,,,,,,,,,
72,,,,,,,,,,,,,,,,
73,,Ps,,,,,Pr,,,,,Ps,,Pr,,
74,,,,,,,,,,,,,,,,
75,,,,,,,,,,,,,,,,
76,,Ps,,,,Pr,,,C,,Ps,,,Pr,,
77,,,,,,,,,,,,,,,,
78,,,,,,,,,,,,,,,,
79,,Ps,,,Pr,,,,,Ps,,,,Pr,,
80,,,,,,,,,,,,,,,,
81,,,,,,,,,,,,,,,,
82,,Ps,,Pr,,,C,,Ps,,,,,Pr,,
83,,,,,,,,,,,,,,,,
84,,,,,,,,,,,,,,,,
85,,Ps,,,Pr,,,,,Ps,,,,Pr,,
86,,,,,,,,,,,,,,,,
87,,,,,,,,,,,,,,,,
88,,Ps,,,,Pr,,,C,,Ps,,,Pr,,
89,,,,,,,,,,,,,,,,
90,,,,,,,,,,,,,,,,
91,,Ps,,,,Pr,,,,,Ps,,,Pr,,
92,,,,,,,,,,,,,,,,
93,,,,,,,,,,,,,,,,
94,,,,,,,,,,,,,,,,
95,,,,,,,,,,,,,,,,
96,,,,,,,,,,,,,,,,
97,,,,,,,,,,,,,,,,
98,,,,,,,,,,,,,,,,
99,,,,,,,,,,,,,,,,
100,,,,,,,,,,,,,,,,
101,,,,,,,,,Js,,Jr,,,,,
102,,,,,,,,,,,,,,,,
103,,Ps,,,,,,,,,,,,Pr,,
104,,,,,,,,,,,,,,,,
105,,,,,,,,,,,,,,,,
106,,,,,,,,,,,,,,,,
107,,,,,,,,,,,,,,,,
108,,,,,,,,,,,,,,,,
109,,,,,,,,,,,,,,,,
110,,,,,,,,,,,,,,,,
111,,,,,,,,,,,,,,,,
112,,,,,,,,,,,,,,,,
113,,,,,,,,,,,,,,,,
114,,,,,,,,,,,,,,,,
115,,,,,,,,,,,,,,,,
116,,,,,,,,C,,,,,,,,
117,,,,,,,,,,,,,,,,
118,,,,,,,Js,,Jr,,,,,,,
119,,,,,,,,,,,,,,,,
120,,Ps,,,,,,,,,,,,Pr,,
121,,,,,,,,,,,,,,,,
122,,,,,,,,,,,,,,,,
123,,,,,,,,,,,,,,,,
124,,,,,,,,,,,,,,,,
125,,,,,,,,,,,,,,,,
126,,,,,,,,,,,,,,,,
127,,,,,,,,,,,,,,,,
128,,,,,,,,,,,,,,,,
129,,,,,,,,,,,,,,,,
130,,,,,,,,,,,,,,,,
131,,,,,,,,,,,,,,,,
132,,,,,,,,,,,,,,,,
133,,,,,,,,,,,,,,,,
134,,,,,,,C,,,,,,,,,
135,,,,,,,,,,,,,,,,
136,,,,,,Js,,Jr,,,,,,,,
137,,,,,,,,,,,,,,,,
138,,Ps,,,,,,,,,,,,Pr,,
139,,,,,,,,,,,,,,,,
140,,,,,,,,,,,,,,,,
141,,,,,,,,,,,,,,,,
142,,,,,,,,,,,,,,,,
143,,,,,,,,,,,,,,,,
144,,,,,,,,,,,,,,,,
145,,,,,,,,,,,,,,,,
146,,,,,,,,,,,,,,,,
147,,,,,,,,,,,,,,,,
148,,,,,,,,,,,,,,,,
149,,,,,,,,,,,,,,,,
150,,,,,,,,,,,,,,,,
151,,,,,,,,,,,,,,,,
152,,,,,,,,,,,,,,,,
153,,,,,,,,,,,,,,,,
154,,,,Js,,Jr,,,,,Js,,Jr,,,
155,,,,,,,,,,,,,,,,
156,,Ps,,,,,Pr,,,Ps,,,,Pr,,
157,,,,,,,,,,,,,,,,
158,,,,,,,,,,,,,,,,
159,,,,,,,,,,,,,,,,
160,,,,,,,,Cp,,,,,,,,
161,,,,,,,,,,,,,,,,
162,,,,,,,,,,,,,,,,
163,,,,,,,,,,,,,,,,
164,,,,,,,,,,,,,,,,
165,,,,,,,,,,,,,,,,
166,,,,,,,,,,,,,,,,
167,,,,,,,,,,,,,,,,
168,,,,,,,,,,,,,,,,
169,,,,,,,,,,,,,,,,
170,,,,,,,,,,,,,,,,
171,,,,,,,E_7,,,,,,,,,
172,,,,,,,,,,,,,,,,
173,,,,,,,,,,,,,,,,
174,,,,,,,,,,,,,,,,
175,,,,,,,,,,,,,,,,
176,,,,,,,,,,,,,,,,
177,,,,,,,,,,,,,,,,
178,,,,,,,,,,,,,,,,
179,,,,,,,,,,,,,,,,
180,,,,,,,,,,,,,,,,
181,,,,,,,,,,,,,,,,
182,,,,,,,,,,,,,,,,
183,,,,,,,,,,,,,,,,
184,,,,,,,,,,,,,,,,
185,,,,,E_7,,,,,,,,,,,
186,,,,,,,,,,,,,,,,
187,,,,,,,,,,,,,,,,
188,,,,,,,,,,,,,,,,
189,,,,,,,,,,,,,,,,
190,,,,,,,,,,,,,,,,
191,,,,,,,,,,,,,,,,
192,,,,,,,,,,,,,,,,
193,,,Ps,,,,Pr,,,,,,,,,
194,,,,,,,,,,,,,,,,
195,,,,,,,,,,,,,,,,
196,,,,,,,,,,,,,,,,
197,,,,,,,,,,,,,,,,
198,,,,,,,,,,,,,,,,
199,,,,,,,,,,E_7,,,,,,
200,,,,,,,,,,,,,,,,
201,,,,,,,,,,,,,,,,
202,,,,,,,,,,,,,,,,
203,,,,,,,,,,,,,,,,
204,,,,,,,,,,,,,,,,
205,,,,,,,,,,,,,,,,
206,,,,,,,,,,,,,,,,
207,,,,,,,,,,,,,,,,
208,,,,,,,,,,,,,,,,
209,,,,,,,,,,,,,,,,
210,,,,,,,,,,,,,,,,
211,,,,,,,,,,,,,,,,
212,,,,,,,,,,,,,,,,
213,,,,,,,,,,,,,,,,
214,,,,,,,,,Ps,,,,,Pr,,
215,,,,,,,,,,,,,,,,
216,,,,,,,,,,,,,,,,
217,,,,,,,,,,,,,,,,
218,,,,,,,,,,,,,,,,
219,,,,,,E_7,,,,,,,,,,
220,,,,,,,,,,,,,,,,
221,,,,,,,,,,,,,,,,
222,,,,,,,,,,,,,,,,
223,,,,,,,,,,,,,,,,
224,,,,,,,,,,,,,,,,
225,,,,,,,,,,,,,,,,
226,,,,,,,,,,,,,,,,
227,,,,,,,,,,,,,,,,
228,,,,,,,,,,,,,,,,
229,,,,,,,,,,,,,,,,
230,,,,,,,,,,,,,,,,
231,,,,,,,,,,,,,,,,
232,,,,,,,,,,,,,,,,
233,,,,,,,,,,,,,,,,
234,,,,,,,,,,,,,,,,
235,,,,,,,,,,,,,,,,
236,,,,,,,,,,,,,,,,
237,,,,,,,,,,,,,,,,
238,,,,,,,,,,,,,,,,
239,,,,,,E_7,,,,,,,,,,
240,,,,,,,,,,,,,,,,
241,,,,,,,,,,,,,,,,
242,,,,,,,,,,Ps,,,,Pr,,
243,,,,,,,,,,,,,,,,
244,,,,,,,,,,,,,,,,
245,,,,,,,,,,,,,,,,
246,,,,,,,,,,,,,,,,
247,,,,,,,,,,,,,,,,
248,,,,,,,,,,,,,,,,
249,,,,,,,,,,,,,,,,
250,,,,,,,,,,,,,,,,
251,,,,,,,,E_7,,,,,,,,
252,,,,,,,,,,,,,,,,
253,,,,,,,,,,,,,,,,
254,,,,,,,,,,,,,,,,
255,,Ps,,,,Pr,,,,,,,,,,
256,,,,,,,,,,,,,,,,
257,,,,,,,,,,,,,,,,
258,,,,,,,,,,,,,,,,
259,,,,,,,,,,,,,,,,
260,,,,,,,,,,,,,,,,
261,,,,,,,,,,,,,,,,
262,,,,,,,,,,,,,,,,
263,,,,,,,,,,,,,,,,
264,,,,,,,,,,E_7,,,,,,
265,,,,,,,,,,,,,,,,
266,,,,,,,,,,,,,,,,
267,,,,,,,,,,,,,,,,
268,,,,,,,,,,,,,,,,
269,,,,,,,,,,,,,,,,
270,,,,,,,,,,,,,,,,
271,,,,,,,,,,,,,,,,
272,,,,,,,,,,,,,,,,
273,,,,,,,,,,,,,,,,
274,,,,,,,,,,,,,,,,
275,,,,,,,,,,,,,,,,
276,,,,,,,,,,,,,,,,
277,,,,,,,,,,,,,,,,
278,,,,,,,,,,,,,,,,
279,,,,,,,,,,,,,,,,
280,,,,,,,,,,,,,,,,
281,,,,,,,,,,,,,,,,
282,,,,,,,,,,,,,,,,
283,,,,,,,,,,,,,,,,
284,,,,,,,,,,,,,,,,
285,,,,,,,,,,,,,,,,
286,,,,,,,,,,Ps,,,,Pr,,
287,,,,,,,,,,,,,,,,
288,,,,,,,,,,,,,,,,
289,,,,,,,,,,,,,,,,
290,,,,,,,,,,,,,,,,
291,,,,,,,,,,,,,,,,
292,,,,,,,,,,,,,,,,
293,,,,,,,,,,,,,,,,
294,,,,,,,,,,,,,,,,
295,,,,,,,,,,,,,,,,
296,,,,,,,,,,,,,,,,
297,,,,,,,,,,,,,,,,
298,,Gs,,,,,,,,,,,,Gr,,
299,,,,,,,,,,,,,,,,
300,,,,,,,,,,,,,,,,
301,,,,,,,,,,,,,,,,
302,,,,,,,,,,,,,,,,
303,,,,,,,,,,,,,,,,
304,,,,,,,,,,,,,,,,
305,,,,,,,,,,,,,,,,
306,,,,,,,,,,,,,,,,
307,,,,,,,,,,,,,,,,
308,,,,,,,,,,,,,,,,
309,,,,,,,,,,,,,,,,
310,,,,,,,,,,,,,,,,
311,,,,,,,,,,,,,,,,
312,,,,,,,,,,,,,,,,
313,,,,,,,,,,,,,,,,
314,,,,,,,,,,,,,,,,
315,,,,,,,,,,,,,,,,
316,,,,,,,,,,,,,,,,
317,,,,,,,,,,,,,,,,
318,,,,,,,,,,,,,,,,
319,,,,,,,,,,,,,,,,
320,,,,,,,,,,,,,,,,
321,,,,,,,,,,,,,,,,
322,,,,,,,,,,,,,,,,
323,,,,,,,,,,,,,,,,
324,,,,,,,,,,,,,,,,
325,,,,,,,,,,,,,,,,
326,,,,,,,,,,,,,,,,
327,,,,,,,,,,,,,,,,
328,,,,,,,,,,,,,,,,
329,,,,,,,,,,,,,,,,
330,,,,,,,,,,,,,,,,
331,,,,,,,,,,,,,,,,
332,,,,,,,,,,,,,,,,
333,,,,,,,,,,,,,,,,
334,,,,,,,,,,,,,,,,
335,,,,,,,,,,,,,,,,
336,,,,,,,,,,,,,,,,
337,,,,,,,,,,,,,,,,
338,,,,,,,,,,,,,,,,
339,,,,,,,,,,,,,,,,
340,,,,,,,,,,,,,,,,
341,,,,,,,,,,,,,,,,
342,,,,,,,,,,,,,,,,
343,,,,,,,,,,,,,,,,
344,,,,,,,,,,,,,,,,
345,,,,,,,,,,,,,,,,
346,,,,,,,,,,,,,,,,
347,,,,,,,,,,,,,,,,
348,,,,,,,,,,,,,,,,
349,Nr,,,,,,,,,,,,,,Nr,
,,,,,,,,,,,,,,,,
